summer	[ˈsʌmə]	n.夏，夏季
responsibility	[risˌpɔnsəˈbiliti]	n.责任(心)；职责
unhappy	[ʌnˈhæpi]	a.不幸福的，不快乐的
trade	[treid]	n.贸易；职业	vi.交易
precaution	[priˈkɔː∫ən]	n.预防；警惕
span	[spæn]	n.跨距；一段时间
kind	[kaind]	n.种类
clay	[klei]	n.粘土，泥土；肉体
furnish[ˈfəːni∫]	vt.供应，提供；装备
digital	[ˈdidʒitl]	a.数字的，计数的
afterward	[ˈɑːftəwəd]	ad.后来，以后
rage	[reidʒ]	n.(一阵)狂怒，盛怒
action	[ˈæk∫ən]	n.行动；作用；功能
steadily	[ˈstedili]	ad.稳定地，不变地
overtime	[ˈəuvətaim]	a.超时的，加班的
resign	[riˈzain]	vt.放弃	vi.辞职
motor	[ˈməutə]	n.发动机；机动车
helpless	[ˈhelplis]	a.无助的；无能的
labour	[ˈleibə(r)]	n.劳动；工作；劳工
champion	[ˈt∫æmpjən]	n.冠军，得胜者
copper	[ˈkɔpə]	n.铜；铜币，铜制器
expensive	[iksˈpensiv]	a.昂贵的，花钱多的
proportion	[prəˈpɔː∫ən]	n.比，比率，部分
not	[nɔt]	ad.不，没有
public	[ˈpʌblik]	a.公众的	n.公众
amplify	[ˈæmplifai]	vt.放大，增强；扩大
mask	[mɑːsk]	n.面具；伪装	vt.掩饰
lady	[ˈleidi]	n.女士，夫人；贵妇人
management	[ˈmænidʒmənt]	n.管理；经营，处理
nice	[nais]	a.美好的，令人愉快的
indirect	[ˌindiˈrekt]	a.间接的；不坦率的
amuse	[əˈmjuːz]	vt.逗…乐；给…娱乐
eve	[iːv]	n.前夜，前夕，前一刻
bang	[bæŋ]	n.巨响，枪声；猛击
riddle	[ˈridl]	n.谜，谜语
contract	[ˈkɔntrækt]	n.契约，合同；婚约
wage	[weidʒ]	n.工资，报酬
incident	[ˈinsidənt]	n.发生的事；事件
response	[risˈpɔns]	n.作答，回答；响应
rely	[riˈlai]	vi.依赖，依靠；信赖
glance	[glɑːns]	vi.看一下	n.一瞥
whether	[ˈ(h)weðə]	conj.是否
republican	[riˈpʌblikən]	a.共和国的
odd	[ɔd]	a.奇数的；单只的
curtain	[ˈkəːtən]	n.帘，窗帘；幕(布)
sweat	[swet]	n.汗	vi.出汗
visual	[ˈvizjuəl]	a.看的；看得见的
parcel	[ˈpɑːsl]	n.包裹，小包，邮包
input	[ˈinput]	n.输入；投入的资金
bee	[biː]	n.蜂，密蜂；忙碌的人
